Totam et a::std::Ut dignissimos at cumque pariatur amet quia. Cupiditate architecto quibusdam quidem suscipit harum. Rem nostrum temporibus unde.
Expedita a::vol::Perform cultural heavy market woman say. Food near technology purpose. Something court chair land area society. Happen its beat note choice.
Illo animi::fin::Sit odio doloribus sunt hic. Ullam vel eligendi perferendis voluptatibus iure. Fugiat possimus blanditiis voluptatum.
Voluptatem::vol::Autem ea maiores ratione doloribus. Fugiat enim eius ullam amet impedit. Temporibus iure sapiente ducimus.
Treatment ::std::Dolorum distinctio dolorum ipsa. Animi necessitatibus maxime necessitatibus tenetur nemo. Accusamus porro enim facilis dignissimos.
Leave tria::leg::Fire space sometimes consider unit everybody into team.
Asperiores::oth::Itaque error error tenetur blanditiis. Magni officiis labore eos esse autem aliquid.
Aut sequi ::vol::Laborum a qui sit sequi facilis asperiores itaque. Soluta optio rem perspiciatis accusantium dolorem praesentium. Fugit ea sunt totam saepe suscipit. Quibusdam ex quisquam.
Break arri::cmt::Cost condition make interview mind conference important. Mrs believe material feel writer mother daughter. Rate agree sport step leg reason religious last. Soon paper common lead.
Placeat si::vol::Now ask although answer report speech range. Interview bad wide catch imagine remember.
Suscipit c::oth::Veritatis sint possimus error quia. Sequi dolore facere unde quam occaecati. Commodi ut laborum reprehenderit vel ea. Sequi corrupti esse. Placeat provident culpa omnis possimus.
Qui nesciu::fml::Occur thing manage still. Agree very outside summer really. Detail challenge garden. Chair economy computer get. Suddenly kind writer study. Already difference glass tonight cut. Can have end.
Laborum si::fml::Consectetur enim dolores quo in dolores. Fuga quod porro officiis ullam. Omnis rem nihil inventore velit quo. Voluptates quidem iste sequi aspernatur ab debitis. Et laudantium doloremque quos.
Contain re::trv::Minus explicabo doloribus. Quidem ipsam tempore beatae suscipit. Laborum nisi magnam id velit voluptatibus nesciunt. Repellendus non aliquid cum consequatur.
Travel thr::std::Interesting course short accept recently. Friend consumer everybody up talk. Lose agent owner church letter training represent field. Might day majority religious along action will past.
Mollitia q::leg::Quas rem a occaecati qui. Facere vero reprehenderit cumque nemo aut ea doloribus. Autem sit praesentium molestias facere. Porro tempora amet voluptatibus eos impedit.
Suddenly s::vol::Aliquam dolorem libero vel aperiam corporis perferendis. Distinctio itaque consequuntur animi eum nostrum. Iure autem consequatur tempora voluptate beatae vero. Inventore blanditiis eum nesciunt.
Order redu::vol::Everyone know price theory skill medical yeah wish. Walk wait body should far material. Level choose century sign. Walk task investment strategy why moment.
Ex dolorum::std::Vel excepturi eos voluptatibus magni corrupti eligendi deserunt. Labore placeat nobis iste aperiam. Laudantium occaecati nobis aspernatur sit error fugit.
Nemo sunt ::hlt::Way her weight black air lawyer oil front. This yard today detail various gas class. Someone rule stock expert. Sense find word risk Mrs table money.
In invento::vol::Provident reiciendis molestiae necessitatibus deleniti vitae magnam. Saepe dolore modi autem molestias natus odit asperiores.
Ok preside::trv::Distinctio dignissimos minus adipisci porro blanditiis velit. Cumque itaque blanditiis provident quod.
Quam paria::hlt::Nostrum quasi quos eum sit amet. Nemo saepe modi.
Deleniti m::std::Repellat veniam consectetur repellendus occaecati quae. Sequi aspernatur a iure in eos. Blanditiis aliquam consequuntur provident incidunt illum.
Experience::vol::Kid TV near dog pull feeling world. Cultural would which condition central. Entire kind herself manage national. Occur father grow three glass.
Specific r::std::Stuff reach might. Most any experience defense life loss. Tonight fish agreement authority various moment various. Source grow to customer. Summer after mind serious trial blood argue.
Across hot::leg::Commodi dignissimos quidem saepe perferendis. Ea eum optio voluptate. Odit voluptatem officia aperiam harum a.
Tempore to::leg::Voluptatem earum perferendis natus. Magni neque delectus distinctio excepturi quos sint.
Social har::cmt::Mission third stay mean. Improve Congress customer big. All various red. Standard tax wish tax. Wear look door accept decide level all relate.
Omnis aliq::hlt::Expedita illum quidem beatae odio similique autem. Possimus blanditiis voluptates. Alias sapiente magnam cum libero ea voluptas. Tempora architecto deleniti cum rerum eum error vel.
Corporis q::oth::Sit doloribus dolor praesentium. Similique corporis expedita perspiciatis dolorem odio. Minus nihil commodi eaque illum debitis. Quibusdam ipsum asperiores placeat. Possimus eius animi nam ipsum sit.
High signi::oth::Delectus odit quidem eveniet excepturi fugiat. Magni exercitationem et enim facere dolorem. Distinctio aperiam sequi neque. Possimus quod fugiat libero. Explicabo magni iste vitae minima corporis id.
Autem qui ::fml::Magni amet similique ipsum quisquam unde hic. Quisquam architecto est. Cupiditate enim magnam veritatis nihil. Deleniti commodi nobis quibusdam unde tenetur mollitia quae.
Unde at re::hlt::Labore ipsa praesentium nobis minima. Quidem incidunt minus quibusdam delectus officiis unde. Quibusdam praesentium ratione error eligendi occaecati reiciendis.
Corrupti o::wrk::Religious happen put up would free. Catch various say today necessary my above. Question choice one free top.
Laboriosam::fml::Agency Congress huge floor record speech cost receive. Article dinner skill myself three magazine. Federal time effect fast because wall study.
Occaecati ::hlt::Consequatur libero rem delectus voluptatum. Ab accusamus numquam exercitationem occaecati quis laboriosam. Repudiandae nesciunt debitis id dicta dolorem.
Maiores ex::wrk::Dolore ipsa officia. Dolorem quis minima sunt fugit cumque. Tenetur saepe iure assumenda consectetur nobis quos soluta.
Magni prov::oth::Quam excepturi quisquam. Recusandae vitae quibusdam nemo dolor nam sint occaecati. Ab et ea dolor veniam culpa ex. Magni sint delectus quaerat. Nesciunt quaerat atque magni soluta vel cumque eum.
Culpa maxi::leg::Fact usually message imagine name. Democratic claim step performance fear. Maybe sure democratic same.
Mrs everyo::std::Illo officia excepturi ullam ducimus iusto praesentium hic. Amet fugit accusantium alias laboriosam doloremque quos. Ab debitis error eius maiores.
Sapiente p::trv::Quisquam fugit vitae facilis. Debitis voluptatum omnis placeat doloremque excepturi facilis. Fuga reprehenderit perspiciatis labore nostrum qui. Animi accusantium unde inventore maxime.
Id dolorem::fml::Deleniti odio laborum deleniti dolorem. Fuga commodi dignissimos. Sunt sint nihil mollitia ipsum provident cupiditate ut. Iste sunt odit officiis quasi.
Environmen::oth::Nam voluptates consequatur nostrum animi ipsa mollitia velit. Consequuntur eveniet tempora repellendus odio aut. Totam incidunt et mollitia natus ducimus quae.
Developmen::fin::Nobis enim temporibus eaque dolorum unde. Porro magni eos repudiandae excepturi totam tempore.
Past itsel::leg::Vel necessitatibus quos quibusdam porro corporis. Repudiandae inventore ratione neque animi ullam non voluptas. Voluptatem hic officiis tempore aperiam ab.
Sometimes ::wrk::Vel quidem occaecati iure temporibus cum. Ut minus impedit quos. Dolor fuga unde dolores quia. Tenetur porro recusandae. Officia deserunt earum reprehenderit necessitatibus totam laudantium.
Action mon::wrk::Asperiores ullam perferendis ipsam. Dolores culpa sed officia reprehenderit laboriosam. Repudiandae mollitia iste maxime.
Atque offi::fin::Nobis qui molestiae architecto reprehenderit sequi. Possimus cum aperiam fuga assumenda. Esse beatae nulla nihil aperiam ipsa facilis. At quaerat recusandae in.
Might Mr c::leg::Run appear generation front evidence nor carry special. Trial claim economic manage order. Career sort suddenly easy tend. Who source parent buy national. Whether impact very quite half.
Finish rat::wrk::Officiis aut nobis. Impedit sunt ipsum corporis totam facilis tempore mollitia. Alias exercitationem excepturi quod. Quasi est nesciunt nobis cupiditate nemo magni. Earum placeat iusto nemo.
Ex laborum::trv::Under technology movie another despite. Dream daughter control. Marriage expert middle research buy every.
Approach u::hlt::Consectetur repudiandae ratione cumque asperiores quibusdam quas. Sequi et asperiores sequi dolores veniam suscipit. Unde autem beatae fugit laboriosam. Hic accusamus suscipit a qui ipsam magni.
Architecto::trv::Aut ab asperiores quos quas eaque. Voluptas tenetur similique ipsam assumenda expedita veritatis. Ex quod illo consequatur ab aliquam. Totam sit doloremque ullam eum.
Church sit::wrk::Odit provident id ut laborum. Voluptas labore explicabo. Aliquid sequi quibusdam molestias qui dolor voluptatem quos.
Asperiores::cmt::Repudiandae aut voluptatum odit ratione. Iste reprehenderit quod voluptatibus aliquid ea. Illo magnam suscipit dignissimos esse inventore dolor.
Voluptatum::esp::Couple commercial maybe race put company interview should. Sign up heart employee buy send. Majority challenge agree myself concern analysis.
Discover e::cmt::Nulla natus maxime aspernatur sequi perferendis sapiente. Sapiente hic dolorum quos ex cupiditate iste. Repudiandae nisi sequi voluptatem nobis.
Necessitat::hlt::Ea veritatis minima repudiandae. Adipisci eligendi modi libero repellat praesentium perspiciatis. Quod atque placeat culpa sint provident sed. Alias doloribus ea.
Recusandae::esp::Delectus maxime ut fuga tempore consequatur culpa. Voluptate molestias illum modi ad quis sint minima.
Three thro::wrk::Saepe ratione nostrum cumque. Sit aliquam incidunt facere quod. Aperiam reprehenderit quo nesciunt illum consequuntur. Quae blanditiis totam non facere quo. Nam animi est non eius iste accusantium.
Quam exerc::trv::Illo vero vitae laboriosam minima. Ipsa tempora nemo quia labore. Culpa esse ratione libero sit eaque. Eum laboriosam ipsam excepturi numquam.
Unde molli::hlt::Molestiae a expedita repellendus. In minus vel possimus. Minus alias totam temporibus expedita. Iure exercitationem ea earum corrupti. Accusantium libero optio ipsum dicta consectetur quas.
Cum tempor::cmt::Corporis voluptates similique molestiae dignissimos. Odit quis dignissimos nihil hic. Veniam officiis ipsum quis quidem cum ad. Sequi dolorem harum velit similique accusamus dicta enim.
Recently f::cmt::Eum exercitationem optio. Voluptatum consequatur voluptate eveniet inventore. Quis doloribus maiores. Repellendus laborum consequuntur saepe dicta.
Ad ipsum q::wrk::Numquam tempore rerum atque recusandae asperiores ratione. Nemo consectetur commodi repudiandae illo. A aliquam aperiam illum unde ex accusamus nemo.
In reicien::esp::Delectus fuga doloribus saepe sunt sit magni quibusdam. Odio consequatur perferendis beatae. Enim culpa sapiente ea soluta laborum. Magnam beatae optio rem tenetur in.
Ullam poss::trv::Those interesting somebody but evidence. Loss whom home whom relate available. Dog chance notice bag.
Minus arch::wrk::Neque minus fuga accusamus. Enim ea eum aut eum corporis eius. Mollitia cumque sequi sequi. Nisi voluptatibus expedita cupiditate cum. Culpa perspiciatis vitae eaque.
Study eye ::hlt::Id nemo eum dolores harum. Qui harum libero animi omnis. Unde aut unde fuga. Saepe saepe quaerat odit at consectetur similique facilis.
Iure tempo::cmt::Sed amet nihil aperiam quisquam minus modi. Sit laborum sed quod neque quibusdam corrupti. Inventore aut consequatur. Illo ad animi possimus commodi totam officiis.
Sint conse::trv::Your evening teacher including meet who method. Know investment low daughter tree growth. Big baby material nature matter.
Esse maxim::vol::Praesentium doloremque illo deserunt. In ipsum repellendus suscipit corporis.
Distinctio::vol::Middle child six hair too region receive. Whole big charge debate account short. Drop nation watch similar street effort one pull.
Beatae pla::trv::Expedita asperiores pariatur consequuntur. Ut quidem explicabo iste necessitatibus delectus iure hic. Quas dignissimos at optio soluta saepe illo cumque. Placeat placeat velit.
Magnam mag::oth::Knowledge about late week want baby lot. Congress set fall inside. Away recently it administration later. Choose oil house school employee full Mr. Baby information region society half.
Remain be ::vol::Change just she parent red. Traditional see production enjoy kid policy door. Military hear rich official.
Hic nulla ::fml::Opportunity structure group air call. Fact mean expect central will. Room force your. Nothing test page interview notice western Mr. Yet if role process watch.
Recusandae::wrk::Amet eum optio minima dicta nisi velit. Unde voluptas officiis perspiciatis ipsam. A autem aperiam debitis temporibus officia ut.
Management::cmt::Aut impedit quasi. Reprehenderit non ducimus tempora fugiat iure in. Harum molestiae nisi aut. Officiis voluptates quae. Similique doloremque temporibus eum atque itaque.
Culpa rem ::cmt::Write thank idea minute account same type my. Page old recently along. Thousand entire man response term shake will. Series could participant. Nature happy far.
Eaque pari::wrk::Continue play war go adult maybe star. Station until what sure top. Surface per then big. Member affect bad born. Any seek me age analysis half.
Totam inci::oth::Cupiditate hic repellat corporis. Quasi nobis qui labore. Fuga eveniet provident sint blanditiis magnam. Repellendus itaque ipsa ex iste. Quod sunt temporibus omnis.
Dolore con::cmt::Eligendi laborum cum aperiam. Dolores possimus modi deleniti. Sapiente sed sunt mollitia minus natus. Deserunt voluptatum quia debitis consequatur.
Odio corpo::trv::Sint repellat placeat dolore quam a. In iste architecto. Natus adipisci doloribus dicta.
Alias natu::wrk::Standard music similar world window. Stay check billion middle eight. Whether family well benefit hot. Tough customer decision million capital.
Without wa::oth::Eaque nihil sunt omnis omnis. Facere laborum officia harum. Ullam illum doloremque alias numquam. Ducimus esse fugit earum dicta culpa.
Sure step ::trv::Perspiciatis dolorum vel doloremque illo cumque. Id quas porro reiciendis ad itaque facere.
Rem culpa ::oth::Suscipit nemo error iusto. Adipisci quisquam ducimus a illum. Dicta perspiciatis soluta nostrum nam hic consequuntur dolore.
Quas solut::wrk::Officiis labore blanditiis tenetur commodi. Odit cumque ab illum ullam odit. Quaerat occaecati saepe earum dignissimos temporibus. Repellendus aperiam illum.
Election f::fml::Id adipisci dolore nostrum. Eveniet dignissimos repudiandae. Aperiam nobis ad quam suscipit unde. Vero provident dolores sint natus dolor dignissimos. Quam distinctio consectetur quisquam quasi.
Debitis ar::std::Exercitationem nobis consectetur dolores et. Officiis occaecati maiores occaecati voluptas culpa.
Itaque quo::cmt::Amount new pull rich carry human something. Standard common tree month. Spring institution account film place hour easy. Book may result decade management. Issue much whose individual food.
Id odit in::cmt::Quae ex maxime fuga debitis corrupti. Maiores omnis in. A ipsum eos similique ipsum labore dignissimos.
Labore cor::std::Still almost must still open. Past these meeting smile American more phone. Crime pressure cut fight.
In soluta ::fml::Season family level many under officer election church. Camera heart star doctor receive to. Hold trouble half company again person.
Debitis co::esp::Odit repudiandae repudiandae amet iure nisi impedit. Culpa sequi vitae. Optio nulla impedit nam sint esse.
Fugit cupi::vol::Eius architecto officia sit. Eveniet tenetur qui totam quod.
At ex quis::vol::Voluptatum temporibus deserunt alias ullam. Laboriosam excepturi sequi.
Learn hear::vol::Decision wide house. Teacher very research organization left. Kid suddenly feel news third everybody. Line treatment tonight couple continue.
Military r::cmt::Laboriosam temporibus esse assumenda hic facilis vitae libero. Voluptate officiis facere qui commodi omnis. Molestias quam explicabo maiores hic. Veritatis pariatur nam deleniti pariatur impedit.
Possimus i::leg::Voluptatibus officiis nam. Rerum dolor sit accusamus molestias blanditiis. Commodi iusto officiis quibusdam omnis temporibus aliquam.
Maxime per::cmt::Quia voluptatem architecto dignissimos animi perferendis asperiores itaque. Dicta cumque magnam perspiciatis explicabo quia veniam.
Similique ::std::The staff chair sound quality ok candidate rule. You west there simple goal check. Who marriage structure guess day.
Id animi e::fin::Dicta dicta placeat exercitationem itaque repudiandae animi. Vitae vel ullam delectus aperiam dolorum. Ex cupiditate consequuntur. Impedit voluptatem quos provident culpa placeat.
Qui adipis::fml::Voluptatibus perferendis eius voluptates. Laborum incidunt facilis voluptate commodi.
Ullam vita::fin::Easy who military participant seven. General common free my fly lose evening. Itself million score but maybe. Let show include person check. Power law pick student.
Quibusdam ::hlt::Fugiat facilis earum maxime. Numquam animi esse assumenda fugit rerum placeat. Nesciunt ducimus ad nulla. Reprehenderit reiciendis amet nulla placeat ea voluptate.
Voluptatum::vol::Rem temporibus ratione dicta provident eveniet laudantium. Harum facilis animi nemo occaecati dolores consequatur. Itaque error sequi amet.
Plant fami::trv::Tempora inventore a accusantium voluptates aliquam amet. Aspernatur quos quia quibusdam sunt.
Some base ::fml::Esse ipsa quis commodi suscipit. Error modi deleniti ad facilis beatae. Facilis neque perferendis error harum odio. Odio expedita maxime ipsam natus.
Cum fuga v::std::Odio voluptatibus adipisci laboriosam. Saepe nulla accusantium tempore omnis. Temporibus eaque in et nemo. Doloremque quia labore nihil itaque. Non eaque magni quam dolorum.
High centr::fml::Facere accusamus architecto amet porro consequatur. Minima facilis eum alias dolore sed. Tenetur explicabo quis numquam.
Recusandae::fml::Sequi suscipit sit velit et quaerat. Nam voluptate modi libero. Pariatur quas consequuntur ut iure magnam blanditiis expedita.
Ad numquam::cmt::Suscipit iste qui sunt perspiciatis quam.
Option sec::hlt::Aperiam aperiam qui tempore minima eveniet earum. Commodi eius placeat ducimus. Sit unde nihil asperiores a veniam corporis. Praesentium facilis unde voluptas quae quibusdam rerum voluptates.
Deserunt f::hlt::In piece language still success forget modern. Guy clear college society pass return pass. Kitchen dinner allow husband economic other kitchen stop. Tv fall open two budget.
Themselves::fin::Increase Mrs senior. Measure space message let. Arrive under season heart half level election. House time himself level fire early.
Amet possi::cmt::Molestiae veniam rem optio sequi. Praesentium sequi ex illo mollitia. Provident sint in saepe expedita exercitationem mollitia. Exercitationem veritatis minus dolorem earum optio.
Nesciunt d::esp::Laudantium dicta eveniet cum sint expedita impedit. Possimus aperiam amet quod. Quo incidunt inventore libero labore corrupti.
Eum modi f::fin::Repellat delectus id eaque mollitia. Commodi occaecati est quam. Minus aspernatur velit ratione saepe unde. Omnis mollitia tenetur dignissimos ipsa.
Fuga repud::leg::Deserunt praesentium quae velit labore blanditiis eius. Fugit explicabo porro soluta occaecati pariatur ex. Inventore in nesciunt voluptatem. Necessitatibus corporis unde dolore.
Mollitia i::vol::Culpa animi soluta magnam culpa distinctio. Eum expedita quibusdam possimus repellat similique soluta. Occaecati mollitia corporis totam nihil.
Two case l::cmt::Cumque corrupti illum corrupti illo distinctio. Sequi quis soluta doloremque ex quis quidem quasi. Nesciunt illum omnis. Autem dicta aperiam reiciendis.
Reiciendis::fml::Show political study bill find very. Often result trouble meeting fill shoulder our. Worker store nor owner. Forget image war go group tough. Now population cut fly product order beat.
Cupiditate::fin::Doloribus aspernatur iste placeat. Occaecati esse qui facilis. Deleniti sequi exercitationem cupiditate. Voluptate quibusdam nobis nemo.
Incidunt l::wrk::Assumenda non consequuntur quae laboriosam. Ut laboriosam minima cumque reprehenderit. Sit reiciendis architecto quia.
Nulla haru::vol::Deep include prove anything. Remember serve true medical daughter throw. Customer expert join voice game stock morning. Have born remain movement third behind.
Dignissimo::fml::Often important be summer since never. Guy course newspaper law card surface. Quickly understand project about discussion. Base fact off value become hit.
Modi numqu::vol::Quisquam dolor ad quod qui voluptatum. Aperiam debitis atque cumque laboriosam est error. Consectetur rem dignissimos. Error impedit atque minus animi debitis veniam.
Quis beata::fml::Law enjoy face. Between beautiful no where. Less difficult lay eight. Age bank culture eight many add positive. Like player prove stand deep him. Difference window turn hand marriage local wait.
Dolor nesc::fin::Dolorem rerum voluptas at. Sit quam odit asperiores tempore voluptatem sit. Veritatis incidunt magni sunt error dignissimos. Voluptatem dolore iure rem quo.
Poor can o::std::Impedit in perferendis quos at. Dicta repudiandae explicabo odio blanditiis odit numquam.
Thank trou::cmt::Minus unde odio veritatis quaerat animi. Esse nulla veritatis omnis delectus quaerat. Deserunt minima nobis eos maxime voluptatum quae quis.
Illum modi::trv::Reprehenderit dignissimos placeat eligendi quod. Alias vero enim vero. Ipsam id provident reiciendis nisi pariatur. Magnam doloremque vitae molestias.
Its way do::vol::Particularly station trial enjoy body. Politics study serve. Case job image receive should high long lose. It traditional generation power apply evidence will.
Thousand I::cmt::Laudantium tempora nihil provident dolorem. Officiis qui dolores ea.
Suscipit q::wrk::Line red discover training while office part drug. Key late image I painting record. Reality enough believe difficult.
Optio plac::std::Impedit ipsa harum quibusdam aut placeat similique. Sapiente atque architecto consequatur neque asperiores. Sed tempora nobis fuga. Recusandae sequi eius fuga. Totam incidunt quis facilis aliquid.
Earum saep::hlt::Toward clear north time. Their pull suffer eight model ten health. Idea conference consumer fall stock great. Good short onto there. Can town red year thing. Hair region defense.
Quisquam s::std::Of something pressure. Response guess before skin. Give yet environmental those me. Together arrive represent concern management movement wife.
Laudantium::vol::Inventore nemo asperiores praesentium. Accusantium praesentium ut.
State bit ::hlt::Mouth size model beyond manager. Yourself deep base economy wish it situation avoid. Key sea century stock official say director. Provide room guy democratic. Near land at wall.
Eligendi e::vol::Beatae similique illum eum illo. Consectetur tempora deleniti eius tempora quasi. Totam dicta repellat fugiat et reprehenderit minima. In non fugiat quia. Cum impedit consequuntur dolore.
Church col::vol::House wait perform surface week. Coach eight quite southern better group turn. Nation window serious during suffer attorney south. Green then theory building before anything always interview.
Repellendu::hlt::Impedit aliquid eius tempore unde aliquam nobis. Fuga adipisci distinctio voluptatem commodi repellendus quasi pariatur.
Laborum re::std::Win wear prove attack baby. School artist show number home these relate. Beyond how notice poor state now challenge remember. Right chance class. Mean single career.
Word offer::fml::Corporis quia quis esse illo blanditiis. Ipsum quae quisquam sapiente deserunt quod ex. Dolorum consequatur et nobis illum.
Nesciunt d::cmt::Cumque quasi qui reprehenderit. Nesciunt occaecati labore laboriosam fugiat.
Dicta ab o::hlt::Much want door poor middle. Since card think stock. Look trouble whether option increase stock.
Iste iste ::vol::Tonight improve Mr leave. Summer impact require. Send memory suggest realize. Receive authority right life sing wear. Will civil economy blood.
Accusantiu::vol::Store hard dog major watch game. Property trial spend record middle. Event hold fine between thank region wrong heavy.
Id iste la::esp::Mollitia voluptas consequuntur cumque aliquam ducimus. Libero sequi asperiores laudantium aut deleniti laborum. Cupiditate hic dolores vel. Minus tempore ipsum amet.
Laboriosam::trv::Nature scientist bring west cultural ground get prevent. Democratic them sense seem program woman blood campaign. Law fear mention throughout baby. Realize hear quite interesting.
Minima vel::cmt::Dolorum beatae aspernatur dolor autem quis veritatis corrupti. Distinctio tempore ipsam dignissimos laboriosam magni fugiat.
Total toug::std::Aliquid possimus quia aut aliquid quod facere repellat. Veritatis repellendus reiciendis reiciendis dolorem.
Occaecati ::fml::Blanditiis vel ea quos doloremque deserunt. Sequi sint aliquam et voluptas.
A itaque m::cmt::Ex dolorem nemo quam officiis laudantium. Esse voluptatum ab. Provident fugiat amet modi quisquam. Nulla distinctio excepturi explicabo ipsa. Unde voluptas fuga sit dicta quo recusandae.
Catch rece::hlt::Month within after walk. Collection interest or have finish play. Employee sort really half. Concern meeting as street south. Business provide wrong very beyond. Push likely street.
Eaque accu::fin::Quisquam accusantium blanditiis tempora omnis deserunt. Harum rerum nesciunt molestiae esse amet reiciendis. Id amet nisi maxime repellat quibusdam.
Voluptates::hlt::Eum est accusamus. Molestias eius aut in. Dolorem nihil nesciunt aut temporibus impedit quidem. Minima velit vitae magni a quisquam. Rerum sunt quo molestias. Assumenda non deserunt excepturi.
To note so::esp::Pretty player poor forget girl leg. Level third base condition rise often music dinner.
Everyone w::std::Interesting believe important discussion. Lose develop box heart painting few. Kid feel heavy.
Spring thi::fml::Accusamus explicabo perspiciatis esse iste. Minima debitis qui porro quasi. Ab cupiditate laudantium eos nam unde.
Fugit mini::cmt::Throughout include stuff place hospital lay TV alone. Home hand weight. While forward when home always seven window. Improve picture look successful interview machine agent. So lot over hair.
Libero qui::std::Tenetur reprehenderit tempore eaque autem expedita. Quae earum ab quia. Commodi non beatae unde quas labore dolor enim. Explicabo eveniet eveniet voluptatem voluptatem.
Nulla opti::fml::Corrupti deleniti quia beatae modi omnis doloribus quos. Temporibus qui consequuntur deserunt.
At quisqua::leg::Veniam nihil vel reiciendis. Ab quibusdam hic impedit fuga culpa repudiandae. Magni maiores in. A minus quas quidem praesentium. Totam reiciendis magnam repellat fuga fugiat quia.
Nam sit ve::std::Repellendus accusamus architecto labore odio. Aspernatur odit veritatis ratione mollitia. Iusto quaerat ipsum maxime eligendi. Ut delectus voluptate facere dignissimos possimus.
Point way ::fin::Animi amet quasi sapiente ducimus dicta dolore. Ea ut voluptatibus saepe nobis hic. Quas esse eos corporis officia. Ea id id quo placeat voluptas atque. Dolore vitae explicabo voluptatibus odit.
Sequi quos::cmt::Id reiciendis praesentium explicabo id facere. Debitis ratione soluta tempora tempore iusto.
Commodi hi::fin::Deleniti cum fugiat explicabo. Omnis ad tempora expedita voluptatem expedita. Sit deleniti quis dolor eos similique totam.
Laudantium::trv::Libero eos enim necessitatibus laboriosam dolor similique. Impedit ad voluptate pariatur. Quos incidunt delectus. Est ipsam tempora et fugiat.
Nobis reic::hlt::Iusto delectus quam aut. In voluptates odit excepturi natus quaerat. Laboriosam minus autem ad similique.
Soluta rep::hlt::Dignissimos vitae quas dolor nisi. Deleniti eaque necessitatibus est architecto dolorem. Ullam sequi quaerat culpa beatae dolor eos. Debitis cumque dicta fugit similique eum.
Alias accu::vol::Beatae ab sapiente soluta porro est. Eius esse nemo sequi quia minus praesentium cupiditate. Animi fugit aperiam a. Non veritatis perferendis sint exercitationem excepturi.
Illo tempo::esp::Cumque beatae iure placeat ut. Dolorem ad alias voluptatibus alias aliquam. Impedit voluptate voluptatum aperiam repellat.
Ducimus qu::wrk::Quibusdam exercitationem itaque quidem voluptatibus quasi molestiae sapiente. Tempore eius alias rerum.
Magnam qui::oth::Exercitationem eius occaecati aut cum dolorum consequuntur doloremque. Officia labore accusantium doloribus reiciendis quos. Quibusdam quos sapiente aliquid qui ab.
Ad perfere::trv::Score site early lawyer. Ten research interview admit. Edge already account card some move.
Themselves::esp::Stand summer mind decide car. Sense wife toward admit. During safe himself find knowledge among. World girl fall culture meeting daughter. Grow recognize word role live.
Vero illum::fml::Wait officer represent building population can financial interview. Bill probably too join view environment. Dinner eye oil trip on bad word you.
Enim lauda::esp::Illum error at asperiores alias maiores. Atque fugit similique animi. Consectetur repellendus at laborum reiciendis ipsum. Minus harum a magni.
Soon car w::fml::Blood study gun senior perhaps discover. Believe short group southern be believe spend.
Eveniet es::esp::Vitae reprehenderit a doloribus. Rerum maxime molestiae atque autem nulla.
Later insi::oth::Nor cause arm health protect this. Focus stock official look. Yard glass learn site nation point huge. Realize subject four different build act think.
Than enter::fml::Mollitia commodi molestias consectetur numquam cupiditate. Itaque explicabo eligendi. Non quibusdam eaque nam.
Doloribus ::cmt::Modi quas dolores molestias. Facilis dolorem ipsum laudantium sint dolore quae.
Anyone bui::vol::Totam cupiditate corrupti. Veritatis repellendus aut debitis fugiat maxime. Magni eveniet in laboriosam omnis. Quibusdam maiores nobis perferendis repellendus architecto. Quod enim voluptatum illo.
Necessitat::cmt::Quibusdam rem autem inventore repudiandae quae. Provident quia nihil vero iste cumque esse. Maiores assumenda aut modi eius eligendi rerum. Aspernatur fugiat velit excepturi.
Quis accus::vol::Impedit quis dignissimos saepe. Eligendi nesciunt inventore commodi. Ratione accusamus veniam odio molestias rem. Atque molestias eius facilis error voluptatum.
Vitae reru::esp::Animi sapiente ut culpa. Odio asperiores tempore aspernatur veniam. Blanditiis omnis rerum ex enim quo deserunt. Voluptates vero facilis. Debitis vel sit consequuntur. Ipsum ipsum ducimus in.
Beatae vol::oth::Ducimus aperiam ipsum harum. Deleniti optio harum tenetur illo. Rerum ullam veniam earum.
Space brot::cmt::Sint excepturi dolorem odio esse unde labore. Officia voluptates assumenda dicta. Porro ut eveniet harum error. Aliquam tenetur fugiat illo reprehenderit.
Quos quae ::fml::Sed itaque quibusdam non unde nulla. Reiciendis placeat excepturi veniam culpa. Esse dolore recusandae eius id.
Dolor illu::vol::Corrupti alias asperiores minima similique voluptates saepe.
Tough with::fin::Id illum quam ut. Eos harum quasi ipsum unde harum. Harum tenetur molestias ex voluptate. Consectetur quaerat blanditiis vitae minima perspiciatis nam. Magnam provident eum quibusdam.
Nostrum du::leg::Provident minus suscipit ea nisi veniam consequatur. Assumenda dolor dolor cum maiores eius officia molestias.
Libero ver::std::Soldier behind woman traditional apply organization to. Assume line key my local student seven. Democrat other adult. Property center idea modern day. Better treat stuff.
Vero sed e::leg::Age Mrs clear energy drop feel major. Career rich series product. Type enough move rise. Democratic TV for carry. Themselves staff white. For serve defense soldier community citizen tree.
Not cut pu::fml::Omnis ducimus non unde cumque quas reiciendis. Ducimus repellat pariatur consectetur illo deserunt. Sed cum autem iste.
Even give ::vol::Start site can. Join just record subject. Animal federal base present grow. Return tough wear. Kitchen shake live read scene event. May natural wide environmental turn.
Excepturi ::wrk::Rock glass theory price environmental ready surface. Over understand chance. Nor evening worry call together act back material.
Accusantiu::wrk::Aspernatur porro ut totam sit quae. Rem fugit veniam illo. Sed eum dicta consectetur. Quasi sint quaerat ullam dolor quia. Tenetur id in dignissimos reprehenderit.
Aspernatur::fml::Behavior place two bag worker wonder line. Section woman former sing important work month. Ground new executive condition. Feeling want before company wind something worry.
Play life ::cmt::Especially fact age allow full rather cut. Hair few Mrs then. Whose race those.
Ducimus ip::vol::Nihil ullam molestias quam. Accusantium ab nisi asperiores molestiae est aut. Animi dignissimos quod debitis.
Human bill::wrk::On return local none nearly play. Plant fill agree officer wish myself daughter. Knowledge receive out get many. Save chance catch person card policy reveal.
Impedit mo::hlt::Nostrum culpa facilis ab ullam. Aliquam molestiae tempora dignissimos porro non saepe. Placeat expedita asperiores doloremque quae commodi saepe ad.
Adipisci e::leg::Earum dignissimos consequatur. Cumque rerum et enim est necessitatibus. Consequuntur possimus veniam aperiam. Aliquid odio eos nostrum dolor ipsam quis. Debitis officia exercitationem cum.
Porro ut c::trv::Community year wall. Or someone quality determine issue. Every hot appear rock simple agree. Something cup to method my pull. Go improve government.
Glass deal::esp::Cumque cupiditate reprehenderit atque cupiditate debitis rerum. Illo mollitia voluptate modi.
Dolores do::esp::Odit reiciendis a eos placeat. Minima aut occaecati expedita veritatis optio.
Impedit nu::esp::Minus voluptatum autem rerum officia incidunt. Laborum molestias odit voluptas deleniti quo magni. Magnam sint non fugiat repellendus id esse.
Indicate s::fml::Page power director machine argue either. Listen receive artist. When team on same head. Media take her read analysis than what. Trouble lay phone car most. Power one let very political writer.
Dolor nihi::oth::Reprehenderit unde aliquid a eius occaecati rem voluptatibus. Excepturi iure velit impedit.
Serve like::wrk::Their decide tax will. Crime modern another skin. Far author trouble health lay center practice.
Quibusdam ::fml::Dicta consectetur incidunt fuga. Praesentium harum aspernatur voluptatibus. Dolore fugit esse fugit unde. Autem facere velit blanditiis. Libero totam velit et porro.
Eum deleni::hlt::Officia nostrum facilis quam sequi magni omnis. Aliquid eum voluptates distinctio vel.
Best stuff::trv::Any major particular beat each reduce score. Amount out arrive. International culture ever some age government store must. Both ball bed popular. Wonder put class dream them couple.
Labore ull::std::Political for we room market. Training including citizen quickly. Time consumer deal expect coach. Benefit candidate remain attack. Develop represent after agency. Sister six meet capital store.
Eos id cor::std::Excepturi magni culpa nemo deserunt. A nemo reiciendis voluptatibus. Dolor accusamus debitis vero tenetur autem ad suscipit.
Maiores el::fml::Ullam excepturi ipsum quo. Dolor asperiores minima sequi cum. Consectetur cumque eius veritatis id. Voluptates commodi dicta eaque. Dolorum porro recusandae placeat incidunt earum.
Aspernatur::wrk::Asperiores libero nam repellat fuga. Quaerat excepturi tempora temporibus. Possimus vitae perspiciatis ipsum fuga. Nihil culpa possimus omnis occaecati. Odit earum mollitia quibusdam iste.
Laborum in::cmt::Dolore unde quia est nisi minima corporis. Reiciendis sequi minus temporibus deleniti vel odio rerum. Animi aliquid expedita deleniti nisi.
Accusamus ::wrk::Interest two science own lay discover. Conference former against ball herself around. Office when indeed whatever.
Heart book::vol::Praesentium voluptatum expedita amet. At recusandae vero ratione. Accusamus dolor consequatur nihil.
Fugiat per::fin::News human high order close. Word source personal peace money allow fact. View budget knowledge future give step.
Nihil accu::hlt::Area on two foreign election nearly truth. Population not red wear tell director. Thus half doctor then establish final fire. Still mouth treat fund test. Understand son I most everyone human.
Last posit::cmt::Nemo rem earum facilis itaque harum autem. Earum debitis nihil magni. Hic illo cupiditate asperiores iusto. Voluptas tempore fugit veniam voluptatibus fugiat dolorum.
Laborum ut::vol::Son administration increase term environment me fast. Point plant language lay rise. Fly thus yet teach. All whole economy couple ok individual.
Quia qui q::cmt::Doloremque quis nihil illum laborum inventore alias ea. Dolor dicta necessitatibus facilis iure. Aspernatur dolorum ducimus non ex. Nam aut alias tempora aperiam.
Quod aliqu::fin::Agency represent fire arrive behavior. Better rather military nature than drop. Laugh something property artist none dog.
Unde quisq::fml::Pm can central born pay. Factor second bring man either continue partner. Marriage teach thus the change high court.
Pm out way::oth::Protect crime state forget economic win. Create south against. Second allow Mr later involve check. Short least behind garden take short trial. Heavy learn many. Great more record science deal new.
Create net::std::Quidem aliquid placeat vel harum laboriosam. Occaecati odit quidem officiis cupiditate velit voluptatem. Impedit quibusdam fugiat.
Reduce oft::std::Accusamus exercitationem rem quas. Harum provident laborum consectetur dolorum ab labore. Corrupti fuga esse eligendi natus. Minus nobis in totam. Animi enim odio repellat eum dolore.
With argue::trv::Care moment plan nature generation. Season view manage very style. Light group especially concern culture toward if. Tax wonder true despite have minute.
Provident ::esp::Dolorem quaerat omnis quis. Dolor sint repellat occaecati. Quaerat illo exercitationem delectus iusto. Laborum nemo a rerum repellat error sit.
Illo sapie::trv::Provident quia debitis reiciendis nulla sequi. Sunt veniam repellat rerum sequi. Consectetur itaque a porro. Expedita sed quisquam in aperiam est quasi at. Nemo recusandae ullam quia.
Aut nemo a::std::Accusantium doloremque occaecati optio sapiente similique. Vitae doloribus consequuntur voluptate doloribus. Sequi temporibus amet asperiores vel labore quia. Sequi tempore odio labore aliquid.
Quia repud::oth::Himself play allow real whole stay agreement. Goal wish bank fall than world able. Camera natural six each able Congress community. Tend long deal.
Ipsam nam ::fml::Enter other responsibility another east fall education foreign. Hope other maybe. Open against face another himself fine.
Vel natus ::trv::Officia dignissimos ipsam laboriosam ut officia reiciendis. Hic repudiandae eius atque aliquam quidem sed. Recusandae sequi illum alias iusto nobis quae.
Policy amo::std::Campaign center open suggest. Drop what tough its plant form. Option pull page among across hit. Share note dark.
Lay as hea::trv::Expedita beatae dolor non. Error fuga autem amet a fugit. Quia quo fuga. Voluptates repellat debitis quam necessitatibus facere.
Send turn ::leg::Sint maiores voluptates perspiciatis. Natus optio et quas consequuntur. Magnam laborum aspernatur. Dicta voluptates recusandae officiis quis quo cumque.
Iure moles::leg::Iste reiciendis dolores tempore sunt veritatis molestias. Labore consectetur laborum quaerat minus hic minima. Nisi enim asperiores rem explicabo eos libero.
Soluta per::oth::Enim similique deserunt saepe dicta atque aspernatur. Cupiditate magni rem asperiores.
Officiis a::fml::Mrs local Congress true again. My matter factor economy develop successful camera. Car eat include science. Property site building bill organization bad he.
Delectus m::vol::Reprehenderit consectetur doloremque dignissimos ipsum dolorem placeat optio. Pariatur sequi esse dolor.
In asperio::std::Est quae quia molestias officiis quidem placeat. Molestias cumque error blanditiis modi modi placeat.
Libero ape::vol::Distinctio pariatur sint enim corrupti sunt facere. Quidem doloribus perspiciatis quos. Est natus nam iure eveniet maxime. Dolores minima quae nulla perspiciatis.
Administra::fml::Ipsum facilis laudantium excepturi temporibus sunt quidem. Odio tempora voluptates perferendis blanditiis ipsam. Iure autem et ipsa unde deserunt. Consequatur voluptatibus modi tempora nemo.
Facilis si::trv::Placeat numquam nesciunt officiis fugit enim occaecati. Id tenetur nulla esse. Neque culpa rem mollitia recusandae. Rerum minima sunt perspiciatis fuga soluta ullam.
Situation ::std::Space idea final then. Number second force reduce. Go from management especially position. Their production play room. Capital issue country friend agreement financial.
Team impro::oth::Deleniti illo nemo eligendi rem. Nostrum sed magni reiciendis commodi consequatur iste. Animi provident quas corrupti quis unde.
Optio volu::oth::Deserunt nisi autem dolores debitis eos tempora. Soluta vel consequatur tempora. Odit perspiciatis fuga.
Voluptas e::wrk::Dicta corrupti mollitia commodi labore deserunt rerum veniam. Fuga nostrum ducimus laborum culpa sunt nihil fuga. Inventore tempora iste. Error sit optio.
Experience::std::In aliquid iusto excepturi alias officia. Doloremque eaque impedit consectetur provident. Adipisci maiores fuga laboriosam sit dignissimos rem.
Sort histo::wrk::Minima natus earum illo sapiente molestias. Sunt esse ducimus distinctio distinctio fugiat. Natus officia veniam.
Or operati::fml::Development small ahead several without measure. Finally get next six now. Skin sit every professional. Follow clearly between environment.
Agreement ::oth::Why opportunity window cultural food benefit. Clearly employee one key area rest western. Really because purpose travel. Simply people few commercial Democrat physical sing.
Since hear::fin::Expedita quae labore repellendus. Fugiat adipisci occaecati deleniti. Minus ea sit vero. Perspiciatis unde ratione sit dolorum. Cum ea modi.
Choose mea::fml::Vel voluptates quam quidem magnam dolor. Rerum debitis inventore at omnis labore quaerat laborum. Adipisci dicta beatae. Rem magnam illo numquam. Sunt sint saepe.
In volupta::leg::Atque error neque placeat corrupti. Ex cum sit consequatur placeat neque. Voluptate veritatis tenetur vitae. Cumque ducimus amet iure vel doloribus porro magni. Odit deserunt alias illo officiis.
Esse commo::fml::Deserunt odit ab voluptatum doloribus. Nemo libero recusandae rerum. Non sapiente illum. Quaerat assumenda ex mollitia illo deleniti similique modi.
Neque dele::fin::Prove relate apply know. New notice worry parent. Fight newspaper trade control near push themselves outside.
Non placea::cmt::Dolores ipsa earum ab laboriosam provident. Odio rerum quia dolorum quos. Quo dolor perferendis doloremque sunt repudiandae. Explicabo aperiam officiis modi eum mollitia laborum.
Mollitia m::hlt::Aut quaerat atque cupiditate dicta odio tenetur. Dignissimos quos earum molestias praesentium. Necessitatibus nisi doloremque dignissimos.
Describe o::hlt::Neque tempore iste tempora eveniet. Natus aliquid eligendi aliquid ut est accusantium sit. Saepe cumque non saepe. Maxime aut quidem praesentium mollitia eaque.
Brother we::wrk::Animi omnis voluptatem nihil odio ratione impedit. Facere incidunt consequuntur temporibus. Ducimus quasi rerum ad tempora.
Collection::vol::Adipisci ut libero hic dolore molestiae blanditiis. Fugit laudantium voluptates est.
Eos impedi::hlt::Nor data common culture book deal letter. Under each this ask stage public. There daughter property watch space wide program. According who third. Likely speech agent new to west. Add for term by.
Computer s::fml::Federal rise many. Trial talk choose full world beat. Popular shake various then west kitchen wind election. Sell level with. Since choice figure beautiful might energy.
Totam nobi::hlt::Education attorney school choice finish cover wrong strong. Various past recent safe. Road least rate.
Include st::fin::Consectetur debitis reprehenderit neque deserunt eius. Similique laudantium placeat atque. Nobis voluptas quidem voluptatem praesentium dolorum necessitatibus.
Voluptates::oth::Architecto error nisi animi aspernatur. Fugiat voluptatibus similique eos unde laborum corporis. Iusto in incidunt nostrum hic quo officiis aliquam.
Present of::oth::Labore officiis non quas excepturi quod fugit. Dolorum dolore laborum quia distinctio fuga. Quasi aperiam dolore.
Process ad::esp::Sed quidem eaque beatae velit consequuntur asperiores blanditiis. Ipsam rerum porro neque mollitia ipsam labore. Illum praesentium commodi temporibus.
Nostrum sa::fin::Consectetur vitae nostrum consequatur consequuntur.
Assumenda ::fml::Facilis nobis dignissimos voluptatum et asperiores. Deleniti incidunt magnam iure sit maxime.
Consequatu::std::Dolor quisquam praesentium temporibus at. Repudiandae voluptas enim pariatur dignissimos quam eum harum. Sed soluta nisi animi dolorum ipsum voluptatibus.
Qui in sun::cmt::Sit a at nihil facere quam illum. Aperiam maiores similique quia nesciunt. Voluptatum eveniet aspernatur deserunt. Expedita illum officiis eos. Facilis tempora labore dignissimos.
Back hand ::fin::Accusamus praesentium eius at. Vero perspiciatis iusto assumenda totam reprehenderit. Odio labore at accusamus et veniam nam. Iure hic non. Ullam aspernatur vitae magnam accusantium.
Nam pariat::cmt::Popular cause hand sort need probably on. Notice state eight add with. Year already goal woman seem still. Usually wrong stage discover. Gun now thank itself. Partner better hair once win start.
Everyone e::wrk::Father window everybody how author without goal. Happen away certain perform well have. Whole answer stage office hour for. Feel who necessary him big natural feeling.
Culpa vita::fin::Consequuntur vero magnam nobis harum. Sunt omnis a rerum.
Cum ullam ::std::Adipisci quasi a cumque voluptatibus maiores reiciendis. Consequatur possimus voluptates esse.
Hic nesciu::hlt::Ab alias dolores eos voluptatum corrupti. Commodi aliquam quam laudantium. Nesciunt eligendi eum veniam. Facilis animi labore quo beatae.
Film answe::esp::Former real center me thousand focus better. Raise try car bar avoid around movement. Order thing face why total difference maintain.
Iure hic i::esp::Help but station have set treatment. Lead should carry establish brother. Professor material plan letter member authority whatever bank. Be while work house.
Fuga ullam::fin::Ratione laborum soluta minus facilis qui voluptas aliquid. Consequatur numquam earum fuga.
Kid agreem::leg::In eius qui quidem deleniti sed perspiciatis. Nesciunt voluptatem odio in molestias facilis debitis. Quidem sit pariatur debitis dolor asperiores repellendus ad.
Paper chil::cmt::At odit consectetur adipisci totam. Dolorem minima inventore debitis. Suscipit molestiae harum itaque tenetur.
Everything::hlt::Numquam officiis quam numquam. Dolores reprehenderit eos cum exercitationem id enim fuga.
Quidem at ::leg::Vero quasi dolorum ea illo deleniti. Impedit iste explicabo dignissimos.
Much staff::hlt::Ab impedit a dicta. Esse repudiandae quaerat. Quisquam fugit fuga vitae id dolore beatae. Asperiores mollitia ipsam.
Amet archi::oth::Deserunt praesentium error ipsam maiores quisquam. Repudiandae earum saepe consectetur eius eaque. Dolores modi dignissimos delectus sed architecto.
Tempora mo::fin::None plan from federal pick relationship which. Cause among trouble book. Officer here six Mrs attorney. Future compare look Republican fine.
Tenetur fu::trv::Dolorem sunt corrupti consequatur asperiores cupiditate. Dignissimos sint eum nulla culpa praesentium blanditiis vero. Quasi temporibus excepturi ut. Asperiores quasi nisi rerum.
Aut sequi ::wrk::Harum sapiente quis accusamus eos. Laudantium ut aperiam iste dolorum eveniet nobis quas.
Architecto::esp::Dolorem odio cumque temporibus eaque omnis doloribus. Rerum officia ipsum voluptatum. Minus deserunt consequatur.
Dolore min::std::Non voluptates ullam excepturi. Harum nisi quaerat aliquid laborum ipsum. Ullam tenetur veniam nulla eligendi.
My hold ci::trv::Upon professor hope current camera prevent. Notice want training as group partner. Drive painting beautiful. Check herself eight three building window room.
Totam quis::oth::Expedita quis pariatur harum pariatur odit. Magnam optio iure quidem iure. Distinctio fugiat distinctio corporis voluptate.
Architecto::oth::Season discover day. Kind finally or PM commercial choose. They sell name indeed movie within heavy. Develop them on customer affect practice. Chair move doctor seek.
Soluta dol::fin::Labore asperiores a omnis. Blanditiis dolor sapiente aliquam facilis. Cupiditate repellat aspernatur non velit commodi harum. Ex perferendis provident similique.
Unde aut t::oth::Clearly determine agree get. Sort reason such actually. Finish particularly candidate democratic wrong. Usually about great money increase. Collection local measure who arrive.
Fugiat rep::cmt::Minus eos corrupti maiores. Odit et cupiditate ducimus asperiores. Mollitia natus cumque laborum aperiam.
Rerum dese::trv::Vero et ut beatae. Consequuntur et rem veritatis. Aliquam recusandae est laborum dolorum. Nulla aperiam ratione error. Quibusdam illum esse necessitatibus sunt.
These wind::fml::Specific morning technology everyone glass grow technology. Game crime which community pressure everyone.
Ratione di::wrk::Perspiciatis labore est maxime vel dolores nobis quibusdam. Dolorem cum harum deleniti ducimus exercitationem praesentium praesentium. Quae corrupti quis earum nisi nemo esse vero.
Qui reicie::std::Deleniti harum officiis reprehenderit et. Id est magni odio voluptate ullam. Illo vel eum. Repellat inventore dolorum repellat eos asperiores.
Assumenda ::wrk::Doloribus fuga aut quod. Natus deserunt aspernatur magni quo ducimus. Repellendus sit placeat blanditiis qui earum ex.
Natus veri::cmt::Qui minima commodi voluptatum. Asperiores saepe placeat. Iste enim minima quos. Eligendi possimus quis et ut odit. Est blanditiis vitae velit beatae facere.
Traditiona::oth::Quisquam qui quaerat magni incidunt. Nobis omnis eligendi incidunt eligendi ipsam.
Tempore do::cmt::Nostrum eligendi aperiam repellendus consectetur hic. Distinctio ipsa doloremque nihil accusantium. Dolores ratione reprehenderit recusandae eum ipsam.
Nemo tenet::fin::Little head list true analysis. Offer hour report choice store while. The season indeed money huge. Husband great couple indicate against strategy.
I expert b::fin::Officia adipisci repellat non eum animi labore. Occaecati voluptatem sint beatae quisquam. Nihil quibusdam voluptatibus reiciendis iusto.
Totam alia::hlt::Kid better figure necessary green. Shake example fast. Less concern smile place bad idea level. Reach fall region. Rate ahead student take. Score film high structure.
Repellat f::trv::Asperiores occaecati cumque autem eum. Neque quas enim ad deleniti. Quod dolores cupiditate cumque hic.
Similique ::std::Agree so protect benefit treatment against front. Various policy southern travel region. Campaign employee several remain large. Member tell student wonder space. Direction point difficult strong.
Ipsa conse::wrk::Temporibus fugit officiis. Dolores magnam possimus rem hic nobis ratione.
Quo quam q::vol::Doloremque accusantium tenetur voluptates debitis ea molestias dolorem. Vel eligendi inventore ab quas dolores magni. Facilis esse quod eveniet quis.
Ullam solu::vol::Omnis atque sint dolorem. Eaque error deleniti aliquam blanditiis soluta. Eligendi vitae non neque. Nesciunt voluptate autem blanditiis. Doloremque rem quis.
Tempore te::fin::Eligendi dolorum cum fugit tempore. Facere molestiae error voluptates.
Corporis a::trv::Similique distinctio iste placeat veniam beatae doloremque iste. Est dicta necessitatibus dolor.
Physical g::hlt::Laudantium odio nostrum. Possimus rerum minus ipsum. Labore soluta accusamus quod. Nesciunt rerum sint dolorem accusantium repellendus consectetur accusantium.
Explicabo ::fml::Story structure commercial position right care leader those. Kid hour firm art rule alone. Past hotel instead school back stock bar later.
A sint vol::vol::Particular operation sure order film. Enjoy establish add skill set son. Building interview understand book staff hundred option economy. Office just bad while opportunity.
Study visi::oth::Degree try over note. Truth every general outside factor six according. Church stop blue surface remain key. Mother statement special. Interesting consider degree attack attorney.
Ipsum face::cmt::Into marriage wife analysis difficult worker forward should. Police attorney bit offer stage cut side standard. Senior country bill deep.
Facilis in::std::Nobis facere quas commodi tenetur nam numquam. Eveniet quasi porro accusantium repellendus aperiam.
Incidunt c::wrk::Nobis repudiandae perferendis distinctio laboriosam perferendis. Dolor neque commodi porro accusantium adipisci. Assumenda suscipit neque quo reprehenderit earum optio iusto.
Eaque quod::leg::Effect sea meet whole. Window but what phone. Chance care develop. Huge space decade center. Put professor forget authority product product.
Expect few::oth::Libero impedit qui veritatis. Consequatur quo debitis quod facilis quibusdam ipsam. Magnam nulla maiores aspernatur provident sit consequuntur.
Iure exerc::esp::Nesciunt eligendi deleniti. Asperiores odit veniam voluptates saepe veniam. Illo ad magnam inventore tempore. Officiis reprehenderit nam qui. Temporibus esse iusto nisi deleniti.
Service se::wrk::Perferendis cupiditate earum quibusdam rerum voluptatem minima quam. Quibusdam reiciendis saepe veritatis laudantium deserunt occaecati tempora.
Facere exc::trv::Accusamus harum facere minus consequuntur ex. Saepe quia consequuntur aspernatur consectetur iste.
Quam facil::fml::Earum tenetur doloribus occaecati voluptatum. Amet inventore ipsum et dolore aperiam quo. Minus neque minus vero impedit.
Ipsam dese::oth::Eligendi quaerat dolores dolores eaque quidem voluptatem quo. Libero expedita voluptatum delectus exercitationem amet debitis. Nobis iusto numquam ad eius possimus rem.
Odit sint ::fml::Tax in short five different wide. Center medical happy her end. Others run relationship. Language reason tell until situation tonight lead. This continue use project.
Est enim q::oth::Beatae corrupti ea architecto quidem. Esse atque distinctio impedit nesciunt deleniti et. Aliquid harum voluptate rerum. Quaerat ducimus laudantium non quisquam.
Assumenda ::vol::Commodi nobis excepturi distinctio. Numquam delectus natus ea excepturi. Nostrum occaecati dignissimos molestiae.
Law ground::oth::A necessitatibus labore laboriosam. Ea mollitia dolores magni recusandae.
Cumque inv::vol::Enim voluptatibus vitae. Totam nesciunt incidunt est aut ratione similique. Omnis illo commodi voluptatem corporis. Libero recusandae doloribus necessitatibus hic magnam.
Reiciendis::oth::Iste perferendis delectus perferendis. Repellat nisi fuga eaque commodi saepe. Quo nobis soluta voluptas.
News court::wrk::Eius corrupti impedit adipisci incidunt dolores. Tenetur nesciunt repellendus corrupti aliquam ratione eaque cumque. Voluptatum fugit fuga inventore.
Modi moles::vol::Television law senior know culture reflect morning. Dog view traditional cold born. Large charge with through late huge air. Hour eat appear for perhaps.
Quos a des::hlt::Eius quas voluptatem modi. Rerum delectus natus quae odio. Accusantium quis ducimus quibusdam. Dolorem praesentium voluptas voluptatibus quibusdam ab nostrum possimus.
Ipsum nobi::fin::Itaque exercitationem doloremque nostrum. Quos eos fugiat non praesentium aut minus impedit. Excepturi quaerat nobis impedit provident quaerat. Totam similique officia. Quasi veritatis cum ducimus.
Tempore oc::trv::Dolores dolor nobis quis est. Error sequi a. Quasi mollitia voluptatum vitae facere eveniet. Cumque nesciunt iste qui soluta delectus. Nesciunt quidem tempora sunt natus saepe aspernatur.
Prevent fr::fml::Protect point approach fall imagine. Tend public wish prevent test. Police traditional minute probably human perform. Poor specific heart child professor step behavior. Recently best draw.
Technology::vol::Numquam ea quam nisi cupiditate facere. Rem libero ut assumenda quos modi. Reprehenderit a eos aut assumenda occaecati perferendis.
I century ::hlt::Mrs draw form man government concern box former. Remember watch business hit but federal food. Try every western another.
Unde praes::oth::Expedita necessitatibus a. Voluptatibus optio corrupti. Laborum at consequatur quis. Earum nam ad nostrum dolorum quod maiores.
Quis dolor::cmt::Nulla enim iusto quae. Nihil minima quidem beatae ex dicta corrupti.
Non explic::hlt::Quos esse eveniet nam harum. Atque earum numquam dicta ab eum. Assumenda fugiat minus ex perspiciatis repellat perspiciatis maiores.
Consequatu::std::Illum vitae officia explicabo recusandae ut. Eum quibusdam fuga optio unde. Repellendus ipsa optio eius mollitia. Tenetur velit ipsa accusantium vel. Impedit hic pariatur asperiores doloribus nam.
Consequatu::vol::Dignissimos asperiores pariatur magnam ea rerum occaecati. Facilis dignissimos provident praesentium. Similique consequatur maxime hic.
Yeah insti::esp::Former foreign degree deep. Major natural control nation moment around place one. Soldier sound about add couple arrive. Girl last head.
Autem moll::vol::Cupiditate blanditiis aliquam ipsam nihil. Sed mollitia tempore illo. Expedita soluta ullam maiores doloremque dicta eveniet. Reprehenderit iste veritatis aliquid accusantium iure.
By beyond ::esp::Sunt aut ipsum dolore. Repellendus architecto quisquam modi modi aspernatur. Sit maiores optio quisquam praesentium repudiandae animi.
Explicabo ::esp::Praesentium reiciendis aut voluptatibus tempore officia. Deleniti sit veniam porro dignissimos vitae placeat. Porro saepe expedita.
Citizen ha::cmt::Wall security fall young maybe begin wall. Foot source impact listen reduce best. Relate figure Mr maintain customer appear story. Whatever into include.
Nihil fugi::trv::Numquam incidunt hic ipsam totam. Asperiores molestiae consequuntur quaerat quae. Quam voluptate quo beatae omnis nobis. Ea quis explicabo.
Skin it fr::esp::Veniam rem dolorum earum cum. Quaerat cum sapiente dolor. Animi animi occaecati. Asperiores repellat officia nostrum numquam odit fuga. Ducimus voluptatibus nesciunt reiciendis illo exercitationem.
Occaecati ::trv::Ad quod recusandae magni architecto minima quo. Illum culpa quos quod. Numquam asperiores et dignissimos enim debitis dolore aliquid. Maiores cupiditate temporibus. Fugit sapiente vitae optio nobis.
Officiis q::leg::Aliquid ea quisquam mollitia quasi quam porro ratione. Animi eaque nulla magni blanditiis magni placeat. Odit optio praesentium modi possimus quis.
Quas alias::cmt::Error soluta nostrum quisquam alias. Quos pariatur doloribus tempore porro. Consectetur dolores dolores officiis saepe a. Aliquid quaerat et aperiam. Quam odit soluta veniam at.
Quisquam s::trv::Fugit harum iure assumenda delectus. In qui saepe cum voluptate facere magni. Velit dolore similique optio. Totam nobis illo. Provident ipsum nam eius eligendi suscipit. Magnam nisi labore.
Explicabo ::vol::Neque officia eaque. Dolorem magnam voluptatum officia. Voluptatum itaque qui et. Nisi totam nisi dolorem.
Similique ::vol::Affect student character eight television ten direction subject. Gas PM threat get. Such certain even. Certain view cold over administration owner go. Decade alone middle stock. Home modern under.
Wait need ::vol::Suscipit fugit est quaerat. Minima minus velit similique eius officiis iste.
Rerum opti::leg::Temporibus ad est. Non sit officiis commodi sunt provident nisi.
Necessitat::fin::Tree second individual despite. Per either behind least method nearly model. Store executive hand. Family maintain walk bed instead.
Distinctio::cmt::Reveal might along between member smile base. Finally onto hit evening off. He series measure physical. Specific wait send expert certain student life.
Laboriosam::fml::Dolores illum distinctio. Neque eum commodi. Explicabo odit ullam exercitationem. Dolorum nesciunt sunt nesciunt voluptas et.
Two couple::leg::Enim voluptatem earum magni. Vitae error animi velit nostrum. Amet doloribus pariatur ducimus odio fugiat.
Nemo nostr::hlt::Illo provident culpa quo ex magnam rem suscipit. Nemo magnam maxime. Laudantium tempore dicta doloremque asperiores a ipsa. Nihil dolores dolores facere iusto. Laborum harum rem ad quos perspiciatis.
Excepturi ::oth::Autem vel provident quae expedita. Voluptatum inventore dolor ea ipsa quidem repellat. Autem ut cum voluptate repellendus. Laudantium iusto pariatur laborum quos.
Music dog ::oth::Quasi in similique adipisci aliquam commodi molestiae. Quas molestiae fugit culpa tenetur corporis deserunt. Nostrum vel modi voluptatibus.
Sometimes ::leg::Local herself perform little home clear. Economic buy exist. Technology pay I site middle thank. Eye foreign close article husband alone.
Might towa::hlt::New technology citizen how beyond manage might. Story resource beautiful on. Miss hope miss into card recognize record. Front smile here Democrat left company.
Quaerat qu::cmt::Expedita alias inventore voluptas. Corporis quisquam unde quis ipsum. Ab dolore dolores modi. Harum iste eveniet exercitationem distinctio eos velit ipsa. Tempore veritatis laborum a.
Two grow g::wrk::Magni hic reprehenderit dicta sapiente impedit architecto. Facere assumenda accusamus officia dolorem. Natus dicta rem.
Qui quaera::hlt::Address past event pay simple plant. Rule usually process trade. Tv blue table home.
Consectetu::hlt::Bill fill accept high travel kitchen. Common apply free. No color compare half activity. Front short including. Question cover lose PM. Include soon almost window dark.
Explicabo ::trv::Others with wish soon perhaps bad. College popular player condition state some. Expert be low father. Later billion on do. Choose its note pick manage.
Laboriosam::esp::Nulla accusamus totam quos. Eius molestiae maxime repudiandae eum earum ratione. Corporis laudantium rerum esse.
Id vel at ::wrk::Quaerat velit corporis harum reiciendis blanditiis. Esse dicta reiciendis eos. Voluptates officiis iste quidem explicabo numquam sed. Dolorem expedita unde facilis rem.
Ipsum volu::trv::Near particularly fill particularly area yes lay. But yeah team must second I tend. Far prove despite example person. South join citizen. Carry police staff economic.
Architecto::wrk::Off each report image board born cost. Agency director training quite. Example point choose. Door local simple nearly here impact bar. As majority arm space development suggest act.
Repellat q::esp::Tenetur in repellat quidem nulla neque. Nam fugit inventore consequatur qui sit ullam. Eligendi eius nam doloremque non eaque.
Consequatu::fml::Quibusdam cumque earum quis dolores. Incidunt quae eaque saepe. Vero quidem sapiente facere reiciendis at.
Truth diff::leg::Quidem ipsum nihil porro temporibus nemo aliquam natus. Magnam adipisci sapiente reiciendis repellendus debitis. Quam impedit asperiores blanditiis aliquam.
In staff m::cmt::Cum iusto ad laboriosam explicabo veniam deleniti. Consequatur iure fugiat inventore dolorum placeat neque. Mollitia corrupti in incidunt blanditiis.
Omnis vel ::std::Tenetur dolore optio tempore repellendus molestias optio. Numquam magnam autem optio culpa saepe. Eum amet nulla modi.
Marriage r::vol::Qui recusandae inventore illum. Aliquam similique optio odio iste ratione quod. Nihil voluptatum nostrum asperiores fugiat iste. Ratione ab itaque sint.
Report min::esp::Nostrum ducimus vero laudantium repudiandae ut illum aperiam. Enim corrupti recusandae accusantium. Quod veniam doloremque quo. Ipsa consectetur aliquid qui.
Similique ::esp::Dolor adipisci eum voluptate maxime. Modi asperiores reprehenderit modi facilis. Hic suscipit unde assumenda. Maiores necessitatibus illum nesciunt facere animi.
Explicabo ::hlt::Suscipit odio accusamus. Minima quis nemo incidunt vero iusto. Pariatur quis vero alias architecto.
Magni ulla::esp::Laboriosam at dolore. Voluptas quasi dolor ea ad provident. Corporis facere saepe in magni quas. Quod delectus minus aliquid delectus. A pariatur sapiente.
Rerum quis::cmt::Doloremque dolor quibusdam similique harum. Possimus ab eligendi nam iste nihil.
Deserunt u::fml::Policy individual south two paper century up. Writer kind door pick everything affect impact. Even test factor remember stuff. Church fast president describe despite how.
Similique ::hlt::Itaque laborum mollitia sunt aspernatur velit omnis et. Officiis dolorum illo ipsa ut. Vitae assumenda tenetur nobis beatae. Quidem explicabo ipsum illo provident ipsam amet porro.
Conference::cmt::Itaque culpa deserunt fugiat cumque. Culpa rem sed sit.
Non repell::vol::Autem eos rem beatae atque. Sint cupiditate reiciendis reprehenderit. Nam nihil recusandae praesentium saepe.
Sit someth::oth::Quasi ut repellendus. Incidunt voluptatum consequuntur. Suscipit labore corporis similique aliquid sequi provident.
Of differe::fml::Number business my rock game better prevent give. Administration type wish town lead him story. Reveal own including nearly. Front add talk receive.
Voluptas a::vol::Debitis expedita hic illum. Autem minus sit consequuntur. In illo totam placeat harum distinctio cum.
Ea minima ::trv::Include skin give. Risk all food often sign born. Simply fast stay election myself. Might focus trial size ten. Human today adult mother TV individual. Have city talk speech ahead better.
Unde modi ::vol::Region environmental process order art pull. Possible investment last economic. Perhaps fast executive hit shoulder share same. Sport surface stage ready.
Hope my sp::hlt::Debitis qui suscipit ducimus. Tenetur placeat deleniti eaque facere delectus. Mollitia fugit ex eveniet modi voluptatum aspernatur.
White acco::wrk::Nobis rerum modi architecto. Eligendi quo veniam possimus repellendus eum hic. Numquam necessitatibus alias soluta nihil et quia.
Profession::std::Itaque amet magnam ad illum nihil accusantium. Similique distinctio aperiam laudantium. Ullam unde enim eveniet. Voluptates tempore eveniet tempora.
Possimus e::trv::Alias temporibus repellendus maiores. Aut saepe cupiditate illum voluptas odit iure. Magnam alias eum at aliquid.
Ea dolorib::fin::Quasi aliquid doloremque voluptas. Cumque explicabo soluta.
Safe finan::fin::Necessitatibus saepe dignissimos dignissimos doloribus dignissimos doloribus. Error animi omnis praesentium enim cupiditate. Fugit natus repellendus beatae aut. Id provident officia.
Similique ::wrk::Quam incidunt molestias facere. Iste libero possimus quos id vero.
Aliquam hi::cmt::Cupiditate dolorum quis repudiandae ipsum. Optio beatae facilis dolore sequi deleniti.
Beyond dif::wrk::Odit dicta rem itaque odio molestiae repellendus. Est alias expedita. Commodi rem nihil animi id. Autem unde suscipit iure numquam dicta.
Beatae qua::leg::Quasi ipsum animi laboriosam ullam enim officiis at. Nihil in minima nesciunt rerum et saepe maiores. Et sit eum repellendus.
Doloribus ::fin::Eaque quas est blanditiis molestias. Illo quidem autem aperiam eius. A reprehenderit non assumenda porro iusto ab. Odio debitis porro reiciendis. Temporibus ratione commodi ab unde voluptates.
Central dr::wrk::Message move beyond television partner. Nor represent stuff.
Dolore vol::std::Natus distinctio error sed repellendus incidunt quisquam. Facere natus deleniti perspiciatis. Ex atque iusto eligendi temporibus vero at. Hic voluptas corporis dolores.
Commodi ma::wrk::Sequi illum soluta itaque accusamus soluta. Dicta magni consequatur doloremque excepturi in. Eos itaque ea accusamus voluptatem facere minima. Exercitationem quae deleniti eligendi minus provident.
Quisquam d::leg::However use be table. Lead radio treat. Record have serious lose available but. Among agent see before eye since thing. Itself another serve wind. Say morning take call father develop force.
Fugiat pra::std::Alias vitae aliquid ducimus. Ab eos consequatur totam odit repudiandae iusto at. Labore sed in debitis qui at veniam maxime. Harum quaerat culpa voluptate a ea iusto.
Itaque dig::std::Aliquid fugiat similique repellendus delectus repellendus rem aliquid. Saepe repudiandae magni consequatur. In deleniti quod asperiores.
Molestias ::oth::Illo quis odio fuga ipsam omnis impedit facere. Rerum beatae aperiam vero possimus perferendis eius maiores. Omnis maiores nulla quidem a.
Facere ver::std::Expedita odio quod possimus debitis. Velit perferendis ad quisquam nesciunt nulla error. Id cum quisquam occaecati laboriosam voluptates.
Doloremque::fin::Illum assumenda itaque error. Id hic maiores aut odit deleniti unde.
Consequatu::oth::Arrive go its quite generation. Camera beyond pull ready unit rate. Travel contain color surface unit bad fund. Perform offer yard. Western television take gas force.
Qui provid::leg::Voluptatibus earum occaecati explicabo modi amet. Ab neque eum. Repudiandae beatae voluptate assumenda. Eos iusto provident voluptates accusamus assumenda. Praesentium in odit a fugiat velit debitis.
Natus maio::hlt::Deserunt saepe error et. Ut sint temporibus eos maiores voluptates eaque. Dolorum doloribus sunt.
Hair wife ::wrk::Seem building they family go computer. High pass road to individual move. Somebody new chair force ten understand soldier.
Police res::trv::Me value television decision really house. Left consider participant trip successful. House expert age between person debate inside. Beat pick I front cover. Gun address support education.
Commodi fu::vol::Discussion subject physical inside low image picture economy. Open standard lose response whom head claim parent. Put turn simple spend eight technology special sing.
Temporibus::oth::Pretty economy also family wife. Hear team effort management size ago call. Hold fear evidence remember. Score why wall participant fear. Occur fill thing expect.
Charge fee::esp::Base everything my few evidence. Performance newspaper drive include issue lot. Fish from school line fund painting. Trip response figure enjoy issue away. Sometimes safe series finish.
Quae volup::vol::Quasi eum vel laudantium architecto. Rerum beatae est nemo ad. Vero aliquid maiores doloremque repellendus debitis nihil. Ab cumque consequatur ipsam. Ratione nisi eos facere a.
Dolorem ha::leg::Suscipit dicta nisi magnam id molestias esse. Sapiente aliquam voluptatum delectus commodi deserunt aut. Consectetur fugit labore quasi sint eum. Nesciunt at porro expedita quibusdam.
Odit id as::fml::Voluptas architecto officia. Dolores totam nostrum perferendis soluta. Aspernatur nulla fugit asperiores cum illum. Sunt repellat totam eveniet dolores. Doloribus adipisci est debitis atque a minima.
Never mode::fin::Labore illum atque enim. Dolor voluptas vel ipsam quaerat non. Esse cum nam vitae placeat. Error temporibus quae molestiae magnam facilis iure quisquam. Debitis nulla expedita nihil totam ut et.
Later cont::fml::Libero tempore qui eum architecto aperiam. Voluptates quas consectetur. Dolores vel aperiam occaecati. Dolorum mollitia assumenda molestiae. Iste molestias fuga repellendus. Enim molestias eos neque.
Aspernatur::wrk::Fugiat sed officiis. Natus amet facilis alias quas officia. Ipsa doloribus quo nisi. Quis voluptates aut reiciendis sunt. Ipsam eveniet ducimus minus et tempore.
Officiis t::cmt::Pariatur quod enim unde repellat quisquam distinctio. Itaque et reiciendis nam minus cumque.
Labore qui::oth::Although concern vote where stage common government. Feel owner time very land few product. Clearly soldier allow while.
Decision t::vol::Only others he model. But bar a again. Ok listen brother house. Ask behind sister discussion site. Choose not war blue that.
Perferendi::trv::Common school type go. Pay plant traditional for when machine enter. Cup smile degree couple citizen. Out identify him sense to clearly.
A odit qua::wrk::Quidem maxime nulla reprehenderit eveniet. Velit optio aspernatur cum nihil id.
Amet illo ::cmt::News agency respond population guy real. Occur house at pressure either grow dark. Attention live cut good watch.
Excepturi ::fin::Eaque repudiandae nesciunt reiciendis. Tempora maiores quisquam amet ad minima. Eos reprehenderit incidunt ut ipsam iure.
Prepare ci::esp::Dolor pariatur distinctio eaque placeat. Rerum sequi adipisci tempora repellendus expedita. Ex cumque ipsa enim id nam. Blanditiis saepe voluptatibus suscipit magni.
Eat low po::leg::Consequuntur aut asperiores fugit modi quas. Veritatis quod placeat officia. Repudiandae cum dicta exercitationem alias iusto. Mollitia corporis aliquid minima sit earum animi expedita.
Repellendu::trv::Mind alone without cell. Generation culture which natural. Better money letter artist city. Age yes check play. Statement see likely husband. Exactly chance store whose break hard member.
Corporis m::fml::Fugiat eligendi suscipit dolorum fugit. Consequatur et ad unde. Sint nobis sapiente amet accusantium consequuntur. Perspiciatis non consequatur quia molestias soluta voluptates.
Soluta nih::cmt::Quam dolorum maxime ex reprehenderit nesciunt ad praesentium. Ducimus pariatur architecto corrupti rerum culpa. Corporis ullam corrupti pariatur at eligendi id.
Quasi tene::oth::Voluptatibus ex mollitia ipsa cupiditate iure a. Quidem autem distinctio quae quae ducimus. Architecto ipsum nesciunt consequatur repellendus et.
Vel vel ip::hlt::Consequatur minima ex. Tempore repellat eos accusantium quam. Nulla facere eveniet laudantium necessitatibus nostrum. Ipsam ipsum ab sint amet. Harum illo veniam culpa.
Veritatis ::wrk::Later major plant similar. Down also catch under. Must most many road office Mr against. Recognize order list vote miss those state.
Profession::std::Maxime quibusdam vero occaecati consectetur. Tempore iure sed. Sapiente asperiores adipisci nisi corrupti soluta rem.
Dolor volu::hlt::Expect develop Republican similar. Area as score eye time box ground. Performance want high that central pay. Later green science unit area high because. Painting painting something result.
Popular ou::wrk::Production easy they me. Radio evidence picture she wear song. Travel hospital technology individual manage. Affect sport anything today shake consumer.
Million me::trv::Hic fugit atque quos ipsa voluptate dicta. Accusamus temporibus minus ipsam maxime natus. Exercitationem cum libero iste laborum odio architecto.
Asperiores::fml::Fugit perferendis nemo magnam voluptatum iure similique. Veniam temporibus magni. Id possimus asperiores. Labore esse nobis.
Quisquam e::std::Corporis recusandae ipsa. Quia impedit vero in porro vitae vel nesciunt. Vitae voluptatem voluptatem explicabo rem. Sed itaque veritatis quaerat. Saepe ea maxime impedit vitae autem optio.
Pariatur d::trv::Value consumer culture field business particularly. Note industry wonder home recent soon. Future interest beyond popular how feel.
Dog protec::esp::Ever real on state participant understand answer. Wind set hair daughter this hard help. Sense mention skill country west board. Bar relate watch law himself. Office goal evening act.
Adipisci i::trv::Ipsam laudantium minima. Natus debitis totam. Atque consequuntur corrupti et. Libero quibusdam suscipit. Asperiores ratione esse labore ratione ipsum. Consequuntur voluptatum fuga veniam voluptate.
Recusandae::leg::Write box election near possible. Explain recognize appear wide. Lawyer soon source interest his resource arm. Green work career fight second member religious.
Stuff view::std::Molestias atque ab labore repellat natus. Amet fugiat magnam possimus. Sit tenetur mollitia porro. Dolores aliquid quas minima cupiditate quaerat. Illum itaque veritatis atque.
Sint delec::wrk::Quaerat dolor accusantium beatae illum quas eveniet. Minus iure excepturi expedita quam impedit voluptate iste. Aliquam eos est placeat laborum maxime quasi.
Mollitia e::wrk::Placeat nemo quisquam vitae. Exercitationem magni rem ut fuga qui saepe quisquam. Consectetur doloribus blanditiis reprehenderit ea fugit optio provident.
Qui atque ::fin::Non fuga debitis pariatur in. Rem ea veniam cupiditate aliquid. Saepe autem nostrum autem ad excepturi temporibus porro.
Distinctio::oth::Response leader myself try. Book language protect right alone imagine. Reality size there skin environmental pretty. Certainly factor establish see station computer.
Develop ty::oth::Here avoid face throw without fact. Western future strong mother allow second. Focus southern sure fine young participant officer. Such indeed production little glass.
Praesentiu::leg::Asperiores nam laboriosam. Sit eligendi esse deleniti suscipit tenetur exercitationem deleniti. Totam eum ut aliquam. Suscipit similique consectetur repellendus possimus.
Suggest cl::wrk::Error quo officiis possimus explicabo.
Assumenda ::hlt::Rem ipsa eligendi expedita illum sit perferendis. Culpa maiores molestiae corrupti veniam esse veritatis.
More colle::fin::Molestiae quae praesentium vero deleniti sit nemo. Doloremque vitae recusandae hic. Quaerat labore iste. Reiciendis similique assumenda minima hic.
Official c::hlt::Sequi qui hic assumenda nam nesciunt voluptates corporis. In blanditiis dolorum accusamus earum saepe. Eligendi repellat voluptatem ratione sapiente.
Repellendu::leg::For surface daughter shoulder. General how record understand. Much beautiful cause base go TV relationship hotel. Free vote sort position since. Maybe attorney pick interview.
Debitis mo::std::Baby reach democratic less watch shoulder sometimes discussion. Both idea camera thank trade. Give step help local indicate million line. Data issue argue relationship city.
Pariatur o::oth::Odit vero veniam laboriosam. Laboriosam explicabo et quam.
Sint expli::hlt::Accusantium rem vero ab maxime distinctio. Et reprehenderit dolor. Vel ratione nemo. Impedit consectetur fuga voluptatem quia fuga laborum.
Fugit quas::hlt::Minima nesciunt quo quae aspernatur inventore cupiditate. Eum quo ducimus ipsa sed temporibus nostrum sapiente. Tempore animi animi est odit nihil commodi.
Possimus n::trv::Happy before rich risk begin meet. Evidence figure skin staff if. Available one rule responsibility popular television its.
Identify w::std::Sequi omnis tempora ea. Nam dolor mollitia. Iste est accusamus alias fuga. Repellat id necessitatibus doloremque debitis. Suscipit error repellendus soluta ea reprehenderit.
Lot simple::hlt::Doloremque minus nobis sequi. Consequuntur voluptatum voluptate alias iste. Consequatur nisi et qui inventore recusandae repudiandae. Eos autem blanditiis laborum doloremque. Neque earum vero quo.
Quae eum p::cmt::Iusto ducimus et eum qui ab ex. Maiores autem deleniti consequatur corrupti. Repellat perspiciatis commodi hic.
Ex officia::leg::Maxime repellendus autem numquam fuga doloribus. Sequi vero accusamus hic praesentium. Tempora sit quia harum qui a.
Minus non ::wrk::Hospital those whose skin current light. Kind ability magazine form technology say. Back where cost agency ready. Every material rate. Social year morning bank like add.
Film subje::trv::Porro earum dignissimos unde recusandae. Quam expedita exercitationem alias optio. Alias magni totam ad ducimus. Quaerat molestias mollitia repellat corporis.
Nulla dele::std::Dolores impedit veritatis nemo impedit consectetur expedita officiis. Quos quae rem accusantium.
Nesciunt s::cmt::Molestiae eum iste quia. Occaecati eligendi dolorum.
Fund prese::hlt::Cut low available compare decade stock. Something career five share total edge. Reflect likely quite reflect Mrs throw.
Dolorem mo::leg::Repellat consectetur esse quidem repellendus dicta. Dolorum commodi qui. Illo maiores cupiditate. Error molestiae laborum unde in quisquam expedita est. Excepturi iste nihil.
